Level 1
1
1
    #####
    #   #
    #@  #
  ###  @##
  #  @ @ #
### # ## #   ######
#   # ## #####  oo#
# @  @          oo#
##### ### #A    oo#
    #     #########
    #######